3 0 0 0 3
0 3 4 3 0
0 2 4 5 8
0 1 2 1 0
0 0 2 0 0
